4

0,0
75,585
5
0,0,50,780,0,0,1,0
50,675,1150,125,1,0,0,0
435,605,215,70,1,1,1,0
650,475,150,200,1,1,1,0
960,575,240,100,1,1,0,0
1
1,0,575,1

1200,0
75,525
6
0,675,300,105,1,0,0,0
0,575,300,100,1,0,1,0
300,225,150,555,1,1,1,1
465,125,240,50,1,1,1,1
850,0,150,525,1,1,1,1
900,625,300,100,1,1,1,1
2
3,0,575,0
1,0,675,2

2400,0
75,585
6
0,625,300,100,1,1,1,1
360,525,240,50,1,1,1,1
475,125,145,250,1,1,1,1
650,225,50,200,1,1,1,1
725,75,275,50,1,1,1,1
1100,0,100,225,1,1,1,1
2
3,0,675,1
0,0,1100,3

2400,-780
1125,625
7
0,200,100,250,1,1,1,1
0,450,200,100,1,1,1,1
225,100,275,50,1,1,1,1
450,375,225,50,1,1,1,1
850,375,225,50,1,1,1,1
1175,0,25,580,1,1,1,1
1100,680,100,100,1,1,1,1
1
2,0,1100,2
