6

0,0
75,585
7
0,0,50,780,0,0,1,0
50,675,910,125,1,0,1,0
435,605,215,70,1,1,1,0
530,575,120,30,1,1,0,0
650,525,150,150,1,1,1,0
800,600,160,75,1,1,1,0
960,575,240,205,1,1,0,0
1
1,0,575,1
0

1200,0
75,525
14
0,575,180,205,1,0,1,0
180,630,320,150,1,0,0,0
245,500,160,50,1,1,1,1
500,450,80,330,1,1,1,0
540,390,40,60,1,1,0,0
130,350,290,50,1,1,1,1
130,290,50,60,1,1,1,0
225,205,250,50,1,1,1,1
550,170,180,30,1,1,1,1
580,200,150,580,0,1,1,0
780,300,130,480,1,1,1,0
910,370,50,410,1,1,1,0
960,490,100,290,1,1,1,0
1060,575,140,205,1,1,0,0
2
3,0,575,0
1,0,575,2
1
1,0

2400,0
75,525
3
0,575,300,205,1,0,0,0
300,225,150,555,1,1,1,0
900,625,300,155,1,1,0,0
2
3,0,575,1
1,0,675,3
0

3600,0
75,575
7
0,625,300,155,1,0,1,0
300,700,900,80,1,0,0,0
360,575,240,50,1,1,1,1
500,175,145,250,1,1,1,1
750,350,50,200,1,1,1,1
725,150,325,50,1,1,1,1
1100,0,100,225,0,1,0,1
2
3,0,675,2
0,0,1100,4
1
1,0

3600,-780
1125,625
9
0,100,100,350,0,0,1,0
0,450,200,100,1,0,1,1
0,0,300,100,0,0,1,1
450,0,750,100,0,1,0,1
225,200,275,50,1,1,1,1
550,475,225,50,1,1,1,1
850,425,175,50,1,1,1,1
1175,100,25,580,0,1,0,1
1100,680,100,100,1,1,0,0
2
2,0,1100,3
0,300,450,5
0

3600,-1560
75,575
2
0,500,300,280,1,0,1,0
450,500,750,280,1,1,0,0
1
2,300,450,4
0