4

0,0
75,325
3
0,0,50,375,1,1,1,1
0,375,450,150,1,1,1,1
850,425,350,150,1,1,1,1
1
1,0,780,1
0

1200,0
75,375
4
0,425,300,150,1,1,1,1
450,475,300,50,1,1,1,1
650,325,50,50,1,1,1,1
550,0,50,125,1,1,1,1
2
0,0,1200,2
3,0,780,0
0

1200,-780
550,675
6
150,225,50,150,1,1,1,1
150,575,250,50,1,1,1,1
300,100,225,50,1,1,1,1
550,725,60,50,1,1,1,1
850,125,100,350,1,1,1,1
950,325,250,100,1,1,1,1
2
1,0,780,3
2,0,1200,1
0

2400,-780
75,275
3
0,325,200,100,1,1,1,1
300,225,150,50,1,1,1,1
450,475,250,100,1,1,1,1
1
3,0,780,2
0

3,0,0,0,0,0,0