3

0,0
100,525
6
0,0,50,780,1,1,1,1
50,575,200,100,1,1,1,1
150,375,100,50,1,1,1,1
350,175,50,425,1,1,1,1
600,650,150,50,1,1,1,1
850,0,100,525,1,1,1,1
1
0,0,1200,1
0

0,-780
825,675
9
0,0,50,730,1,1,1,1
200,300,900,50,1,1,1,1
450,350,100,275,1,1,1,1
425,625,150,50,1,1,1,1
500,0,50,75,1,1,1,1
900,0,50,75,1,1,1,1
750,375,50,350,1,1,1,1
850,725,100,50,1,1,1,1
1100,0,100,780,1,1,1,1
2
0,0,1200,2
2,0,1200,0
0

0,-1560
525,625
9
0,0,100,780,1,1,1,1
100,175,300,50,1,1,1,1
200,375,150,50,1,1,1,1
200,575,150,50,1,1,1,1
500,675,50,100,1,1,1,1
600,175,150,50,1,1,1,1
700,175,50,600,1,1,1,1
900,675,50,100,1,1,1,1
1150,0,50,780,1,1,1,1
1
2,0,1200,1
0

2,0,0,0,0,0,0